####################
####################
##................##
##................##
##................##
##................##
##................##
##................##
##................##
##................##
##................##
##................##
##................##
##................##
##........##########
##............^.####
##...............###
##.........#####@v##
####################
####################