####################
####################
##................##
##................##
##................##
##................##
##................##
##................##
##................##
##........v.......##
##......#^@.......##
##......###.......##
##................##
##................##
##................##
##................##
##................##
##................##
####################
####################