####################
####################
##................##
##................##
##................##
##................##
##................##
##................##
##................##
##................##
##................##
##................##
##................##
##................##
####..............##
##v#..............##
##@######^........##
##.........#########
####################
####################