####################
####################
##................##
##................##
##................##
##................##
##................##
##................##
##................##
##................##
##................##
##................##
##................##
##................##
##.......v####....##
##.........@^#....##
##.........###....##
##................##
####################
####################