####################
####################
##................##
##................##
##................##
##................##
##................##
##................##
##................##
##................##
##................##
##................##
##................##
##................##
##................##
##.......###......##
##.......#v..#######
############....@^##
####################
####################