####################
####################
##................##
##................##
##................##
##.............#####
##.............#v@##
##.............##.##
##................##
##................##
##.............##^##
##.............#####
##................##
##................##
##................##
##................##
##................##
##................##
####################
####################