####################
####################
##................##
##................##
##................##
##................##
##................##
##................##
##................##
##................##
##................##
##########v.......##
##########@.......##
##.........#......##
##.........#......##
##.......#.#......##
##.......#^#.....##
##.......###......##
####################
####################