####################
####################
###.#.######...#####
##.#.....#.#..#.#.##
##.####.##.#.#.#..##
##.#.##.###..###.###
##..###.##..#.#..###
##.#..#.#####..#####
##.#..#.####.##.#.##
##.###..#@##.###.###
##..##....###.##.###
##.#.###v.^##..#####
##.####.###.##.#.###
##.###..#.##.###.###
##.##.##.#...##.####
##.#.###.###..#.#.##
##.#.#.#..###...####
##.#.#.#..###...####
####################
####################