####################
####################
##................##
##................##
##................##
##................##
##................##
##................##
##............###.##
##............#v#.##
##............#.####
##..............^@##
##......############
##................##
##................##
##................##
##................##
##................##
####################
####################