####################
####################
##................##
##........#.......##
##.......#.#......##
##.......#.#......##
##.......#.#......##
##.......#.#......##
##########.#########
##................##
##########.#########
##.......#.#......##
##.......#.#......##
##.......#.#......##
##.......#@#......##
##.......#^#......##
##........#.......##
##................##
####################
####################