####################
####################
##................##
##................##
##................##
##......######....##
##......#@.v......##
##......#^...#....##
##......######....##
##................##
##................##
##................##
##................##
##................##
##................##
##................##
##................##
##................##
####################
####################