####################
####################
##................##
##................##
##................##
##................##
##................##
##................##
##................##
##................##
##................##
##................##
##................##
##................##
##................##
##................##
######^.############
##v@..............##
####################
####################