####################
####################
##................##
##................##
##................##
##................##
##................##
##................##
##................##
##.......###.##...##
##.......^..@v#...##
##.......######...##
##................##
##................##
##................##
##................##
##................##
##................##
####################
####################