####################
####################
##................##
##................##
##................##
##................##
##................##
##.............#####
##.............v####
##...........#..####
##...........#.@^###
##...........#######
##................##
##................##
##................##
##................##
##................##
##................##
####################
####################