####################
####################
##................##
##................##
##..........###...##
##..........#^#...##
##........v..@....##
##................##
##................##
##................##
##................##
##................##
##................##
##................##
##................##
##................##
##................##
##................##
####################
####################