##################################################
##################################################
##..............................................##
##..............................................##
##..............................................##
##..............................................##
##..............................................##
##..............................................##
##..............................................##
##..............................................##
##..............................................##
##..............................................##
##..............................................##
##..............................................##
##..............................................##
##..............................................##
##..............................................##
##..............................................##
##..............................................##
##..............................................##
##..............................................##
##..............................................##
##..............................................##
##..............................................##
##..............................................##
##..............................................##
##..............................................##
##..............................................##
##..............................................##
##..............................................##
##..............................................##
##..............................................##
##..............................................##
##..............................................##
##..............................................##
##..............................................##
##..............................................##
##..............................................##
##..............................................##
##..............................................##
##..............................................##
##.................................##...........##
##.................................#............##
##.................................#@##.........##
##..................................#...........##
##..............................................##
##..............................................##
##..............................................##
##################################################
##################################################