####################
####################
##................##
##................##
##................##
##................##
##................##
##.........^......##
##................##
##................##
##................##
##.........@......##
##.........v......##
##................##
##................##
##................##
##................##
##................##
####################
####################