####################
####################
##................##
##................##
##................##
##................##
##................##
##................##
##................##
##................##
##................##
##................##
##................##
######............##
####v#............##
##...#............##
##@#.#............##
##^###............##
####################
####################