####################
####################
##^####...........##
##@##v#...........##
##................##
#######...........##
##................##
##................##
##................##
##................##
##................##
##................##
##................##
##................##
##................##
##................##
##................##
##................##
####################
####################